11111111
1E0000B1
10P100C1
11111111
