1111111111111
10B000C000001
11110000BB0C1
100E000001111
1P0000C00C001
1111111111111