12345678901234567890
2------------------/
3------------------/
4------------------/
5------------------/
6------------------X