1111111111111111111
100000000A000000001
1111111111111111111