1111111111
1E010000P1
10010C0001
1111111111