1234567890123456789
2-----------------/
3-----------------/
4-----------------/
5-----------------/
6-----------------X