1111111111
1C010000P1
10E10C0001
1111111111