1111111111
1C0100E0P1
10010C0001
1111111111