111111111111111111
1000000000000000P1
10000000C000000001
100000000000000001
1E0000000000000001
111111111111111111