11111111111111111111111
1000100000000000P000001
10001000C00000000000001
10001000000011100000001
1E000000000010000000001
10000000000000000000001
11111111111111111111111