123456789012345678
2000000000000000P1
30000000C000000001
400000000000000001
5E0000000000000001
611111111111111111