11111111
1E000001
10P100C1
11111111
