111111111111111111
1000100000000000P1
10001000C000000001
100010000000111001
1E0000000000100001
111111111111111111