1111111111111
100000C000001
11110000000C1
100E000001111
1P0000C00C001
1111111111111