11111111111111111111111
100C100000000000P000001
10001000C00000000000001
10001000000011100000001
1E001000000010000000001
100000000CC000000000001
11111111111111111111111