11111111111111111111111
100CC0000000000000000C1
10001000C00000000000001
10001000000011100000001
1E0010000000100000P0001
10C010000CC000000000001
11111111111111111111111