11111111111111111111111
1000000C000C00000000001
10111111111111110111101
10010000000000000000001
10010011111111111110001
10010010000CCC000110001
10010C10000011110010001
10011110000100010010001
10000000001000100001001
10001111111000010001001
100000C11100001C0001001
10000001111000010001001
10000000000000100C00101
10011111111111111111101
100000000P00E11100001C1
11111111111111111111111