1111111111111111111111111111111111111111
100010000C0000000010CC00P0000000C0000001
1C0010C0000000110111111000CCCC00000000C1
1C0010000000001111110C1000000CCC00000CC1
100C1000CCC000111000CC1000CCCC000000CCC1
10001000000000100011111000CCCC00000CCCC1
100010000000001011111110CCCC00000000C0C1
1C0000C0000000000E11111000000C0000000C01
10000CC00000001110000110000CC00000000001
1C000CC0000000111111000000000C0000000001
1C00000000000000C11111100000000C00000001
100010000000001011111110CCCC00000000C0C1
1C0000C000000000C11111000000C00000000C01
10000CC00000001110000110000CC00000000001
1C000CC0000000111111000000000C0000000001
1C00000000000000C11111100000000C00000001
1C0010C0000000110111111000CCCC00000000C1
1C0010000000001111110C1000000CCC00000CC1
100C1000CCC000111000CC1000CCCC000000CCC1
10001000000000000011111000CCCC00000CCCC1
1111111111111111111111111111111111111111