11111111111111111111111
100CC000000B000000000C1
10001000C00000000000B01
10001000000011100000001
1E0010B00B00100000P0001
10C010000CC000000000001
11111111111111111111111