1111111111111111111111111111111111111111
100010000C0000000010CC00P0000000B0000001
1C0010B0000000110111111000BBBB00000000C1
1C0010000000001111110C1000000BBB00000CC1
100B1000CCC000111000CB1000BBBB000000CCB1
10001000000000100011111000BBBB00000CCBC1
100010000000001011111110BBBB00000000C0C1
1C0000C0000000000E11111000000C0000000C01
10000BB00000001110000110000BB00000000001
1C000BB0000000111111000000000C0000000001
1C00000000000000B11111100000000C00000001
100010000000001011111110BBBB00000000C0C1
1C0000C000000000C11111000000C00000000C01
10000BB00000001110000110000BB00000000001
1C000BB0000000111111000000000C0000000001
1C00000000000000B11111100000000C00000001
1C0010B0000000110111111000BBBB00000000C1
1C0010000000001111110C1000000BBB00000CC1
100B1000CCC000111000CB1000BBBB000000CCB1
10001000000000000011111000BBBB00000BCCC1
1111111111111111111111111111111111111111